####################################
#                                  #
#                                  #
#                                  #
#                  S               #
#                                 E#
####################################