####################################
# #  ##  ######## # #      #     # #
# #   #             # #        #   #
#   # ##### ## ###### # #######  # #
### # ##    ##     S# # #     ######
#   #    #  #######   #   ###    #E#
####################################