####################################
# #  ##  ######## # #      #     # #
# #   #             # #        #   #
#   # ##### ## ###### # #######  # #
### # ##    ##     S# # #     #### #
#   #    #  #######   #   ###    # #
####################################