####################################
# #  ##  ######## # #      #     # #
# #   #             # #        #   #
#   # ##### ## ###### # #######  # #
### # ##    ##     S# # #     #### #
#   #    #  #######   #   ###    #E#
####################################